8 11
___________
00000000000
0_________0
0___000___0
0___000___0
0___00____0
0___00____0
_____0_____