7 6
XXXXBX
XOOOOX
XOXXOX
XOOOOX
XXOXOX
XOOOOX
XCXXXX