7 6
XXXXOX
XOOOOX
XOXXOX
XOOOOX
XXOXOX
XOOOOX
XCXXXX